111111111111111111111111111111111111111111111111111111111111111111111111111111111111111111111111111111111111111111111111111111111111111111111111111111111111111111111111111111111111111111111111111111111111111111111111111111111111111111111111111111111111111111111111111111111111111111111111111111111111111111111111111111111111111111111111111111111111111111111111
111111111111111111111111111111111111111111111111111111111111111111111111111111111111111111111111111111111111111111111111111111111111111111111111111111111111111111111111111111111111111111111111111111111111111111111111111111111111111111111111111111111111111111111111111111111111111111111111111111111111111111111111111111111111111111111111111111111111111111111111
110000100000000000000000000000000000001100000020020020100001000100000000000000000000000000010000000000000000000000000020000000000000000000000000000000000000000000000000000000000000000001000000000000000000000000000000000000000000000000000000000000000000000000100000000000000000000000000000000000000000000000000000000000000000000000000000000000000000000000000011
110000100000000000000000000000000000001100000000000000100001040100000000000000000000000000010000000000000000000000000020000000000000000000000000000000000000000000000000000000000000000000100000000000000000000000000000000000000000000000000000000000000000000000100000000000000000000000000000000000000000000000000000000000000000000000000000000000000000000000000011
110000100000200000000000002200000000001100000000000000100001000100000000000000000000000000010000000011111111111111111111111111111111111111111000000000000000000000000000000000000000000000010000000000000000000000000000000000000000000000000000000000000000000000100000000000000000000000000000000000000000000000000000000000000000000000000000000000000000000000000011
110000100000200000000000000000000000001100000000000000100001040100000000000000000000000000010000000000000000000000000030000000000000000000000000000000000000000000000211120000000000000000001000000000000000000000000000000000000000000000000000000000000000000000100000000000000000000000000000000000000000000000000000000000000000000000000000000000000000000000000011
110000100000200000010000000000400000001100000400040000100001000100000000000000000000000000010000000011111111111111111111111111111111111111111000000000000000000000000100010000000000000000000100000000000000000000000000222200000000004000000000000000000000000000100000000000000000000000000000000000000000000000000000000000000000000000000000000000000000000000000011
110000100000000000010000000000040000001100000000000000100001000100000000000000000000000000010000000000000000000000000030000000000000000000000000000000000000000000000211120000000000000000000010000000000000000000000000000000000000000000000000000000000000000000100000000000000000000000000000000000000000000000000000000000000000000000000000000000000000000000000011
110000100000111111110000000000004000001100000000000000111111000111111111111111111111111111110000000011111111111111111111111111111111111111111000000000000000000000000400040000400000000000000001000000000000000000000000000000000000000000000400000000000000000000100000000000000000000000000000000000000000000000000000000000000000000000000000000000000000000000000011
110000000000000000000000000000000000000000000000000000000000000000000400040004004000400040000000000000000000000000220000000000000000400000000000000000000000000000000000000000000000000000000000111111111111111000000000000000000000004000000000040000000000000000111111111111111111111111111111111100000000000000000000000000000000000000000000000000000000000000000011
110000000000000000000000000000000000000000000000000000000000000000000004000400040040004000000000000000040000400400000000000004004004000040000000000000000000000000000400040000400000000000000000000000000000000000000000000000000000000000000400000004000000000000000000000000000000000000000000000000000000000000000000000000000000000000000000000000000000000000000000
110000000000111111110000000000004000001100000000000000111111000111111111111111111111111111110000000000040000400400000000000004004004000040000000000000000000000000000000000000000000000000000000000000000000000000000000000000000000004000000000040000000000000000111111111111111111111111111111111100000000000000000000000000000000000000000000000000000000500000000000
110000100000000000010000000000040000001100000000000000100001000100000000000000000000000000010000000000000000000000330000000000000000400000000000000000000000000000000400040000400000000000000000011111111111111000000000000000000000000000000400000000000000000000100000000000000000000000000000000000000000000000000000000000000000000000000000000000000000000000000000
110000100000030000010000000000400000001100000400040000100001040100000000000000000000000000010000000001111111111111111111111111111111111111111000000000000000000000000311130000000000000000000000100000000000000000000000333300000000004000000000000000000000000000100000000000000000000000000000000000000000000000000000000000000000000000000000000000000000000000000011
110000100000030000010000000000000000001100000000000000100001000100000000000000000000000000010000000000000000000000000030000000000000000000000000000000000000000000000100010000000000000000000001000000000000000000000000000000000000000000000000000000000000000000100000000000000000000000000000000000000000000000000000000000000000000000000000000000000000000000000011
110000100000030000000000000000000000001100000000000000100001040100000000000000000000000000010000000001111111111111111111111111111111111111111000000000000000000000000311130000000000000000000010000000000000000000000000000000000000000000000000000000000000000000100000000000000000000000000000000000000000000000000000000000000000000000000000000000000000000000000011
110000100000000000000000000000000000001100000000000000100001000100000000000000000000000000010000000000000000000000000030000000000000000000000000000000000000000000000000000sd000000000000000000100000000000000000000000000000000000000000000000000000000000000000000100000000000000000000000000000000000000000000000000000000000000000000000000000000000000000000000000011
110000100000010000000000000000000000001100000000000000100001040100000000000000000000000000010000000001111111111111111111111111111111111111111000000000000000000000000000000000000000000000001000000000000000000000000000000000000000000000000000000000000000000000100000000000000000000000000000000000000000000000000000000000000000000000000000000000000000000000000011
110000100000010000000000002200000000001100000000000000100001000100000000000000000000000000010000000000000000000000000040000000000000000000000000000000000000000000000000000000000000000000010000000000000000000000000000000000000000000000000000000000000000000000100000000000000000000000000000000000000000000000000000000000000000000000000000000000000000000000000011
110000100000010000000000000000000000001100000000000000100001000100000000000000000000000000010000000000000000000000000040000000000000000000000000000000000000000000000000000000000000000000100000000000000000000000000000000000000000000000000000000000000000000000100000000000000000000000000000000000000000000000000000000000000000000000000000000000000000000000000011
110000100000010000000000000000000000001100000300300300100001000100000000000000000000000000010000000000000000000000000040000000000000000000000000000000000000000000000000000000000000000001000000000000000000000000000000000000000000000000000000000000000000000000100000000000000000000000000000000000000000000000000000000000000000000000000000000000000000000000000011
111111111111111111111111111111111111111111111111111111111111111111111111111111111111111111111111111111111111111111111111111111111111111111111111111111111111111111111111111111111111111111111111111111111111111111111111111111111111111111111111111111111111111111111111111111111111111111111111111111111111111111111111111111111111111111111111111111111111111111111111
111111111111111111111111111111111111111111111111111111111111111111111111111111111111111111111111111111111111111111111111111111111111111111111111111111111111111111111111111111111111111111111111111111111111111111111111111111111111111111111111111111111111111111111111111111111111111111111111111111111111111111111111111111111111111111111111111111111111111111111111
